"filename", "language", "Java", "comment", "blank", "total"
"/Users/shawnchen/Desktop/http-server/src/http/server/auth/BasicAuthenticate.java", "Java", 40, 0, 17, 57
"/Users/shawnchen/Desktop/http-server/src/http/server/bean/ChannelStatus.java", "Java", 4, 0, 2, 6
"/Users/shawnchen/Desktop/http-server/src/http/server/bean/ConfigField.java", "Java", 21, 0, 7, 28
"/Users/shawnchen/Desktop/http-server/src/http/server/bean/Const.java", "Java", 17, 0, 3, 20
"/Users/shawnchen/Desktop/http-server/src/http/server/bean/Context.java", "Java", 3, 0, 3, 6
"/Users/shawnchen/Desktop/http-server/src/http/server/bean/Field.java", "Java", 61, 2, 7, 70
"/Users/shawnchen/Desktop/http-server/src/http/server/bean/Method.java", "Java", 25, 2, 7, 34
"/Users/shawnchen/Desktop/http-server/src/http/server/bean/StatusCode.java", "Java", 60, 5, 12, 77
"/Users/shawnchen/Desktop/http-server/src/http/server/bean/URL.java", "Java", 24, 0, 9, 33
"/Users/shawnchen/Desktop/http-server/src/http/server/context/Context.java", "Java", 3, 0, 3, 6
"/Users/shawnchen/Desktop/http-server/src/http/server/context/ContextWrapper.java", "Java", 3, 0, 3, 6
"/Users/shawnchen/Desktop/http-server/src/http/server/cookie/Cookie.java", "Java", 3, 0, 3, 6
"/Users/shawnchen/Desktop/http-server/src/http/server/cookie/CookieWrapper.java", "Java", 3, 0, 3, 6
"/Users/shawnchen/Desktop/http-server/src/http/server/filter/Filter.java", "Java", 3, 0, 4, 7
"/Users/shawnchen/Desktop/http-server/src/http/server/listener/Listener.java", "Java", 3, 0, 3, 6
"/Users/shawnchen/Desktop/http-server/src/http/server/log/AccessLog.java", "Java", 47, 0, 17, 64
"/Users/shawnchen/Desktop/http-server/src/http/server/log/ErrorLog.java", "Java", 3, 0, 3, 6
"/Users/shawnchen/Desktop/http-server/src/http/server/log/Log.java", "Java", 3, 0, 3, 6
"/Users/shawnchen/Desktop/http-server/src/http/server/log/LogWriter.java", "Java", 3, 0, 2, 5
"/Users/shawnchen/Desktop/http-server/src/http/server/main/Main.java", "Java", 12, 0, 7, 19
"/Users/shawnchen/Desktop/http-server/src/http/server/net/AcceptHandler.java", "Java", 27, 0, 10, 37
"/Users/shawnchen/Desktop/http-server/src/http/server/net/BaseHandler.java", "Java", 25, 0, 9, 34
"/Users/shawnchen/Desktop/http-server/src/http/server/net/ChannelMap.java", "Java", 27, 0, 13, 40
"/Users/shawnchen/Desktop/http-server/src/http/server/net/Handler.java", "Java", 4, 0, 2, 6
"/Users/shawnchen/Desktop/http-server/src/http/server/net/ReadHandler.java", "Java", 34, 0, 10, 44
"/Users/shawnchen/Desktop/http-server/src/http/server/net/Server.java", "Java", 58, 0, 17, 75
"/Users/shawnchen/Desktop/http-server/src/http/server/net/WriteHandler.java", "Java", 57, 0, 20, 77
"/Users/shawnchen/Desktop/http-server/src/http/server/request/Request.java", "Java", 19, 0, 18, 37
"/Users/shawnchen/Desktop/http-server/src/http/server/request/RequestHeaderParser.java", "Java", 134, 0, 45, 179
"/Users/shawnchen/Desktop/http-server/src/http/server/request/RequestWrapper.java", "Java", 164, 2, 45, 211
"/Users/shawnchen/Desktop/http-server/src/http/server/response/Response.java", "Java", 37, 0, 36, 73
"/Users/shawnchen/Desktop/http-server/src/http/server/response/ResponseHeaderBuilder.java", "Java", 115, 0, 26, 141
"/Users/shawnchen/Desktop/http-server/src/http/server/response/ResponseWrapper.java", "Java", 183, 1, 47, 231
"/Users/shawnchen/Desktop/http-server/src/http/server/servlet/DefaultServlet.java", "Java", 146, 0, 25, 171
"/Users/shawnchen/Desktop/http-server/src/http/server/servlet/DynamicServlet.java", "Java", 14, 0, 9, 23
"/Users/shawnchen/Desktop/http-server/src/http/server/servlet/Servlet.java", "Java", 8, 0, 7, 15
"/Users/shawnchen/Desktop/http-server/src/http/server/servlet/StaticServlet.java", "Java", 14, 0, 8, 22
"/Users/shawnchen/Desktop/http-server/src/http/server/session/Session.java", "Java", 3, 0, 3, 6
"/Users/shawnchen/Desktop/http-server/src/http/server/session/SessionWrapper.java", "Java", 3, 0, 3, 6
"/Users/shawnchen/Desktop/http-server/src/http/server/task/LifeCycle.java", "Java", 62, 14, 27, 103
"/Users/shawnchen/Desktop/http-server/src/http/server/task/LifeCycleExecution.java", "Java", 24, 0, 10, 34
"/Users/shawnchen/Desktop/http-server/src/http/server/util/Config.java", "Java", 31, 0, 9, 40
"/Users/shawnchen/Desktop/http-server/src/http/server/util/Util.java", "Java", 33, 2, 11, 46
"Total", "-", 1563, 28, 528, 2119