"filename", "language", "Java", "Properties", "Makefile", "HTML", "comment", "blank", "total"
"/Users/shawnchen/Desktop/http-server/src/Makefile", "Makefile", 0, 0, 16, 0, 1, 7, 24
"/Users/shawnchen/Desktop/http-server/src/http.properties", "Properties", 0, 6, 0, 0, 0, 3, 9
"/Users/shawnchen/Desktop/http-server/src/http/server/auth/Authenticator.java", "Java", 3, 0, 0, 0, 0, 3, 6
"/Users/shawnchen/Desktop/http-server/src/http/server/auth/AuthenticatorBase.java", "Java", 4, 0, 0, 0, 0, 3, 7
"/Users/shawnchen/Desktop/http-server/src/http/server/auth/BasicAuthenticator.java", "Java", 40, 0, 0, 0, 5, 17, 62
"/Users/shawnchen/Desktop/http-server/src/http/server/auth/DigestAuthenticator.java", "Java", 3, 0, 0, 0, 0, 3, 6
"/Users/shawnchen/Desktop/http-server/src/http/server/auth/FormAuthenticator.java", "Java", 3, 0, 0, 0, 0, 3, 6
"/Users/shawnchen/Desktop/http-server/src/http/server/auth/SSLAuthenticator.java", "Java", 3, 0, 0, 0, 0, 3, 6
"/Users/shawnchen/Desktop/http-server/src/http/server/bean/ChannelStatus.java", "Java", 4, 0, 0, 0, 0, 2, 6
"/Users/shawnchen/Desktop/http-server/src/http/server/bean/ConfigField.java", "Java", 21, 0, 0, 0, 0, 7, 28
"/Users/shawnchen/Desktop/http-server/src/http/server/bean/Const.java", "Java", 17, 0, 0, 0, 0, 3, 20
"/Users/shawnchen/Desktop/http-server/src/http/server/bean/Context.java", "Java", 3, 0, 0, 0, 0, 3, 6
"/Users/shawnchen/Desktop/http-server/src/http/server/bean/Field.java", "Java", 61, 0, 0, 0, 2, 7, 70
"/Users/shawnchen/Desktop/http-server/src/http/server/bean/Method.java", "Java", 25, 0, 0, 0, 2, 7, 34
"/Users/shawnchen/Desktop/http-server/src/http/server/bean/StatusCode.java", "Java", 60, 0, 0, 0, 5, 12, 77
"/Users/shawnchen/Desktop/http-server/src/http/server/bean/URL.java", "Java", 24, 0, 0, 0, 0, 9, 33
"/Users/shawnchen/Desktop/http-server/src/http/server/context/Context.java", "Java", 3, 0, 0, 0, 0, 3, 6
"/Users/shawnchen/Desktop/http-server/src/http/server/context/ContextWrapper.java", "Java", 3, 0, 0, 0, 0, 3, 6
"/Users/shawnchen/Desktop/http-server/src/http/server/cookie/Cookie.java", "Java", 3, 0, 0, 0, 0, 3, 6
"/Users/shawnchen/Desktop/http-server/src/http/server/cookie/CookieWrapper.java", "Java", 3, 0, 0, 0, 0, 3, 6
"/Users/shawnchen/Desktop/http-server/src/http/server/filter/Filter.java", "Java", 3, 0, 0, 0, 0, 4, 7
"/Users/shawnchen/Desktop/http-server/src/http/server/listener/Listener.java", "Java", 3, 0, 0, 0, 0, 3, 6
"/Users/shawnchen/Desktop/http-server/src/http/server/log/AccessLog.java", "Java", 47, 0, 0, 0, 0, 17, 64
"/Users/shawnchen/Desktop/http-server/src/http/server/log/ErrorLog.java", "Java", 3, 0, 0, 0, 0, 3, 6
"/Users/shawnchen/Desktop/http-server/src/http/server/log/Log.java", "Java", 3, 0, 0, 0, 0, 3, 6
"/Users/shawnchen/Desktop/http-server/src/http/server/log/LogWriter.java", "Java", 3, 0, 0, 0, 0, 2, 5
"/Users/shawnchen/Desktop/http-server/src/http/server/main/Main.java", "Java", 12, 0, 0, 0, 0, 7, 19
"/Users/shawnchen/Desktop/http-server/src/http/server/net/AcceptHandler.java", "Java", 27, 0, 0, 0, 4, 10, 41
"/Users/shawnchen/Desktop/http-server/src/http/server/net/BaseHandler.java", "Java", 25, 0, 0, 0, 0, 9, 34
"/Users/shawnchen/Desktop/http-server/src/http/server/net/ChannelMap.java", "Java", 27, 0, 0, 0, 6, 10, 43
"/Users/shawnchen/Desktop/http-server/src/http/server/net/Handler.java", "Java", 4, 0, 0, 0, 0, 2, 6
"/Users/shawnchen/Desktop/http-server/src/http/server/net/ReadHandler.java", "Java", 34, 0, 0, 0, 8, 10, 52
"/Users/shawnchen/Desktop/http-server/src/http/server/net/Server.java", "Java", 58, 0, 0, 0, 8, 17, 83
"/Users/shawnchen/Desktop/http-server/src/http/server/net/WriteHandler.java", "Java", 57, 0, 0, 0, 3, 20, 80
"/Users/shawnchen/Desktop/http-server/src/http/server/request/Request.java", "Java", 19, 0, 0, 0, 0, 18, 37
"/Users/shawnchen/Desktop/http-server/src/http/server/request/RequestHeaderParser.java", "Java", 134, 0, 0, 0, 9, 45, 188
"/Users/shawnchen/Desktop/http-server/src/http/server/request/RequestWrapper.java", "Java", 164, 0, 0, 0, 2, 45, 211
"/Users/shawnchen/Desktop/http-server/src/http/server/response/Response.java", "Java", 37, 0, 0, 0, 0, 36, 73
"/Users/shawnchen/Desktop/http-server/src/http/server/response/ResponseHeaderBuilder.java", "Java", 115, 0, 0, 0, 1, 26, 142
"/Users/shawnchen/Desktop/http-server/src/http/server/response/ResponseWrapper.java", "Java", 183, 0, 0, 0, 1, 47, 231
"/Users/shawnchen/Desktop/http-server/src/http/server/servlet/DefaultServlet.java", "Java", 145, 0, 0, 0, 5, 25, 175
"/Users/shawnchen/Desktop/http-server/src/http/server/servlet/DynamicServlet.java", "Java", 14, 0, 0, 0, 0, 9, 23
"/Users/shawnchen/Desktop/http-server/src/http/server/servlet/Servlet.java", "Java", 8, 0, 0, 0, 0, 7, 15
"/Users/shawnchen/Desktop/http-server/src/http/server/servlet/StaticServlet.java", "Java", 14, 0, 0, 0, 0, 8, 22
"/Users/shawnchen/Desktop/http-server/src/http/server/session/Session.java", "Java", 3, 0, 0, 0, 0, 3, 6
"/Users/shawnchen/Desktop/http-server/src/http/server/session/SessionWrapper.java", "Java", 3, 0, 0, 0, 0, 3, 6
"/Users/shawnchen/Desktop/http-server/src/http/server/task/LifeCycle.java", "Java", 62, 0, 0, 0, 14, 27, 103
"/Users/shawnchen/Desktop/http-server/src/http/server/task/LifeCycleExecution.java", "Java", 24, 0, 0, 0, 0, 10, 34
"/Users/shawnchen/Desktop/http-server/src/http/server/util/Config.java", "Java", 31, 0, 0, 0, 0, 9, 40
"/Users/shawnchen/Desktop/http-server/src/http/server/util/Util.java", "Java", 33, 0, 0, 0, 2, 11, 46
"/Users/shawnchen/Desktop/http-server/src/wwwroot/index.html", "HTML", 0, 0, 0, 28, 0, 2, 30
"Total", "-", 1578, 6, 16, 28, 78, 552, 2258